╔═══════════╗
║○○○○○○○○○○○║
║○╥○╞═╦═╡○╥○║
║○║○○○║○○○║○║
║○╚═╡○╨○╞═╝○║
║○    R    ○║
║○╥ ╔╡ ╞╗ ╥○║
║○║ ║   ║ ║○║
║○║ ╚═══╝ ║○║
║○║       ║○║
║○╨○╞═══╡○╨○║
║○○○○○▵○○○○○║
╚═══════════╝