                       
                       
 ○                   ○ 
  ╔═════════════════╗  
  ║                 ║  
  ║ ╔═╗ ╥   ╔═╡ ╋ ╋ ║  
  ║ ╠═╣ ║   ╠═╡  ╋  ║  
  ║ ╨ ╨ ╚═╡ ╚═╡ ╋ ╋ ║  
  ║        ▵        ║  
  ╚═════════════════╝  
 ○                   ○ 
                       
